*******************
*.       .       .*
* *   *** ***   * *
* *      .      * *
* * .   * *   . * *
* *   *** ***   * *
*.  .    #    .  .*
* *   *** ***   * *
* * .   * *   . * *
* *      .      * *
* *   *** ***   * *
*.       .       .*
*******************