XXXXXXXXXXXXXXX
X             X
X             X
X             X
X             X
X             X
X      O      X
X             X
X             X
X             X
X             X
X             X
X             X
X      F      X
X             X
X             X
XXXXXXXXXXXXXXX