***************************
*............*............*
*.****.*****.*.*****.****.*
*.****.*****.*.*****.****.*
*.****.*****.*.*****.****.*
*.........................*
*.****.**.*******.**.****.*
*.****.**.*******.**.****.*
*......**....*....**......*
******.*****.*.*****.******
*    *.*****.*.*****.*    *
*    *.**.........**.*    *
******.**.***-***.**.******
..........*     *..........
******.**.*     *.**.******
*    *.**.*******.**.*    *
*    *.**....#....**.*    *
******.**.*******.**.******
*............*............*
*.****.*****.*.*****.****.*
*.****.*****.*.*****.****.*
*...**...............**...*
***.**.**.*******.**.**.***
*......**....*....**......*
*.**********.*.**********.*
*.........................*
***************************